

(a (b c) d)

   |
   v

0: [a]*     0: [a]*     0: [c]
1: [2]      1: [6]      1: [-]
2: [4]      2: [b]      2: [b]
3: [8]      3: [4]      3: [0]
4: [b]      4: [c]      4: [d]
5: [6]      5: [-]      5: [-]
6: [c]      6: [2]      6: [2]
7: [-]      7: [8]      7: [4]
8: [d]      8: [d]      8: [a]*
9: [-]      9: [-]      9: [6]

4: [d -]
3: [c -]
2: [b 3]
1: [2 4]
0: [a 1]
